###################
#........#........#
#.##.###.#.###.##.#
#.....G...........#
#.##.#.#####.#.##.#
#....#...#...#....#
####.###.#.###.####
   #.#.......#.#
####.#.## ##.#.####
#......# C #...G..#
####.#.#####.#.####
   #.#.......#.#
####.#.#####.#.####
#...G....#........#
#.##.###.#.###.##.#
#..#...........#..#
##.#.#.#####.#.#.##
#....#...#...#....#
#.######.#.######.#
#............G....#
###################